3333333333333333333333333333333333333333333333333333333333333333333333333333333333333333333333
3333333333333333333333333333333333333333333333333333333333333333333333333333333333333333333333
3333333333333333333443333333333333333334433333333333333333333333333333333333333333333333333333
3333333333333333333443333333333333333334400000000000000000333333333333333333333333333333333333
3333333333333333333334333333333333333333303333333333333330333333333333333333333333333333333333
3333333333300000000000000000000000000000003333333333333330333333333333333333333333333333333333
3333333333333333333333333333333333333333333333333333333330333333333333333333333333333333333333
3333333333333333333333333333333333333333333333333333333330333333333333333333333333333333333333
3333333333333333333333333331111111111111111111111111113330333333333333333333333333333333333333
3333333333333333333333333331333333333333333333333333333330333333333333333333333333333333333333
3333333333333333333333333331300000000000000000000000000000333333333333333333333333333333333333
3333333333333333333333333331333443322222222222223333333333333333333333333333333333333333333333
3333333333333333333333333331333443322222222222223333313332333333333333333333333333333333333333
3333333333333333333333333331333333322222222222223333313332333333333333333333333333333333333333
3333333333333333333333333331333333322222222222223333313332333333333333333333333333333333333333
3333333333333333333333333331333333322222222222223333313332333333333333333333333333333333333333
3333333333333333333333333331333333333333333333333333313332333333333333333333333333333333333333
3333333333333333333333333331333333333333333333333333313332333333333333333333333333333333333333
3333333333333333333333333331111111111111111111111111113332333333333333333333333333333333333333
3333333333333333333333333333333333333333333333333333333332333333333333333333333333333333333333
3333333333333333333333333333333333333333333333333333333332333333333333333333333333333333333333
3333333333333333333333333333333333333333333333333333333332333333333333333333333333333333333333
3333333333333333333333333333333333333333333333333333333332333333333333333333333333333333333333
3333333333333333333333333333333333333333333333333333333332333333333333333333333333333333333333
3333333333333333333333333333333333333333333333333333333332333333333333333333333333333333333333
3333333333333333333333333333333333333333333333333333333332333333333333333333333333333333333333
3333333333333333333333333333333333333333333333333333333332333333333333333333333333333333333333
3333333333333333333333333333333333333333333333333333333332333333333333333333333333333333333333
3333333333333333333333333333333333333333333333333332222222222222333333333333333333333333333333
3333333333333333333333333333333333333333333333333334444444444444333333333333333333333333333333
3333333333333333333333333333333333333333333333333333333333333333333333333333333333333333333333
3333333333333333333333333333333333333333333333333333333333333333333333333333333333333333333333
3333333333333333333444444444444444333333333333333333333333333333333333333333333333333333333333
3333333333333333333444444444444444333333333333333333333333333333333333333333333333333333333333
3333333333333333333444444444444444333333333333333333333333333333333333333333333333333333333333
3333333333333333333333333333333333333333333333333333333333333333333333333333333333333333333333
3333333333333333333333333333333333333333333333333333333333333333333333333333333333333333333333
3333333333333333333333333333333333333333333333333333333333333333333333333333333333333333333333
3333333333333333333333333333333333333333333333333333333333333333333333333333333333333333333333
3333333333333333333333333333333333333333333333333333333333333333333333333333333333333333333333
3333333333333333333333333333333333333333333333333333333333333333333333333333333333333333333333
3333333333333333333333333333333333333333333333333333333333333333333333333333333333333333333333
3333333333333333333333333333333333333333333333333333333333333333333333333333333333333333333333
3333333333333333333333333333333333333333333333333333333333333333333333333333333333333333333333
3333333333333333333333333333333333333333333333333333333333333333333333333333333333333333333333